α射线	alphashexian	α線
安全帽	anquanmao	ヘルメット
爆炸	baozha	爆発
β射线	betashexian	β線
钚	bu	プルトニウム
避难所	bìnànsuǒ	避難所
撤离	cheli	脱出
冲走	chongzou	(津波に)さらわれる
淡定	danding	冷静(な,に)
倒塌	daota	(家屋の)倒壊
碘	dian	ヨウ素
电力供应	dianligongying	電力供給
地震预警系统	dizhenyujingxitong	地震予知システム
放射性同位素	fangshexingtongweisu	放射性同位体
废核燃料	feiheranliao	使用済み核燃料（＝核乏燃料）
辐射线	fushexian	放射線
γ射线	gammashexian	γ線
工装	gongzhuang	作業着
工作人员	gongzuorenyuan	係員
国际原子能机构	guójìyuánzǐnéngjīgòu	国際原子力機関 (IAEA)
海啸	haixiao	津波
号召	haozhao	呼び掛け
核电站	hedianzhan	原子力発電所
核乏燃料	hefaranliao	使用済み核燃料（＝废核燃料）
核辐射	hefushe	放射能
核心熔毁	hexinronghui	炉心融解
核裂变	hélièbiàn	核分裂反応
级	ji	マグニチュード
节电	jiedian	節電
计划停电	jihuatingdian	計画停電
经济舱症候群	jingjicangzhenghouqun	エコノミークラス症候群
捐款	juankuan	募金
捐赠	juanzeng	(物資の)寄付
抗震	kangzhen	耐震
媒体	meiti	メディア
名单	mingdan	名簿
平安	pingan	安否,無事
平安信息	pinganxinxi	安否情報
硼酸	péngsuān	ホウ酸
抢购	qianggou	買い占め
切尔诺贝利	qieernuobeili	チェルノブイリ
氢爆炸	qingbaozha	水素爆発
氢气	qingqi	水素
日本东北大地震	ribendongbeidadizhen	東日本大地震
日本红十字会	ribenhongshizihui	日本赤十字
散布	sanbu	(デマを)広める
铯	se	セシウム
上修	shangxiu	上方修正
失踪	shizong	行方不明
失踪者	shizongzhe	行方不明者
受灾	shouzai	被災,罹災
搜救	soujiu	捜索救出活動
太平洋海域	taipingyanghaiyu	太平洋沖
天谴	tianqian	天罰
网上寻人	wangshangxunren	(Google) Person Finder
下跌	xiadie	(株価の)下落
消息	xiaoxi	安否情報
泄漏	xielou	（放射能）漏れ
西弗	xifu	シーベルト
袭击	xiji	襲撃
谣言	yaoyan	デマ
医疗救护所	yiliaojiuhusuo	医療救護所
铀	you	ウラン
油罐	youguan	オイルタンク
遇难者	yunanzhe	(震災で)死亡した人
灾害用留言板	zaihaiyongliuyanban	災害用伝言板
灾害用留言电话	zaihaiyongliuyandianhua	災害用伝言ダイヤル
灾区	zaiqu	被災地
震中	zhenzhong	震源
直升机	zhishengji	ヘリコプター
志愿者	zhiyuanzhe	ボランティア
中子	zhōngzǐ	中性子